"filename", "language", "Markdown", "Solidity", "JavaScript", "JavaScript React", "comment", "blank", "total"
"/Users/user/init/myApp/1day10k/2020-/2022/202212/1201-1210/1202/auction/auction.jsx", "JavaScript React", 0, 0, 0, 9, 0, 4, 13
"/Users/user/init/myApp/1day10k/2020-/2022/202212/1201-1210/1202/auction/auction.sol", "Solidity", 0, 46, 0, 0, 0, 14, 60
"/Users/user/init/myApp/1day10k/2020-/2022/202212/1201-1210/1202/auction/ductAuction.sol", "Solidity", 0, 45, 0, 0, 10, 8, 63
"/Users/user/init/myApp/1day10k/2020-/2022/202212/1201-1210/1202/crowFund/crowFund.sol", "Solidity", 0, 63, 0, 0, 10, 13, 86
"/Users/user/init/myApp/1day10k/2020-/2022/202212/1201-1210/1202/erc/erc20.sol", "Solidity", 0, 33, 0, 0, 0, 9, 42
"/Users/user/init/myApp/1day10k/2020-/2022/202212/1201-1210/1202/erc/erc721.sol", "Solidity", 0, 4, 0, 0, 0, 3, 7
"/Users/user/init/myApp/1day10k/2020-/2022/202212/1201-1210/1202/example/example.js", "JavaScript", 0, 0, 0, 0, 0, 1, 1
"/Users/user/init/myApp/1day10k/2020-/2022/202212/1201-1210/1202/example/example.sol", "Solidity", 0, 0, 0, 0, 0, 1, 1
"/Users/user/init/myApp/1day10k/2020-/2022/202212/1201-1210/1202/example/example.test.js", "JavaScript", 0, 0, 0, 0, 0, 1, 1
"/Users/user/init/myApp/1day10k/2020-/2022/202212/1201-1210/1202/js/express.js", "JavaScript", 0, 0, 0, 0, 0, 1, 1
"/Users/user/init/myApp/1day10k/2020-/2022/202212/1201-1210/1202/js/statement.js", "JavaScript", 0, 0, 35, 0, 0, 11, 46
"/Users/user/init/myApp/1day10k/2020-/2022/202212/1201-1210/1202/line.md", "Markdown", 16, 0, 0, 0, 0, 0, 16
"/Users/user/init/myApp/1day10k/2020-/2022/202212/1201-1210/1202/sol/express.sol", "Solidity", 0, 0, 0, 0, 0, 1, 1
"/Users/user/init/myApp/1day10k/2020-/2022/202212/1201-1210/1202/sol/statement.sol", "Solidity", 0, 7, 0, 0, 0, 5, 12
"/Users/user/init/myApp/1day10k/2020-/2022/202212/1201-1210/1202/test/example.test.js", "JavaScript", 0, 0, 11, 0, 1, 4, 16
"/Users/user/init/myApp/1day10k/2020-/2022/202212/1201-1210/1202/thing/chair/chair.js", "JavaScript", 0, 0, 0, 0, 0, 1, 1
"/Users/user/init/myApp/1day10k/2020-/2022/202212/1201-1210/1202/thing/chair/chair.sol", "Solidity", 0, 13, 0, 0, 0, 8, 21
"/Users/user/init/myApp/1day10k/2020-/2022/202212/1201-1210/1202/thing/door/door.js", "JavaScript", 0, 0, 0, 0, 0, 1, 1
"/Users/user/init/myApp/1day10k/2020-/2022/202212/1201-1210/1202/thing/door/door.sol", "Solidity", 0, 21, 0, 0, 0, 8, 29
"/Users/user/init/myApp/1day10k/2020-/2022/202212/1201-1210/1202/vendingmachine.sol", "Solidity", 0, 17, 0, 0, 0, 7, 24
"Total", "-", 16, 249, 46, 9, 21, 101, 442