"filename", "language", "Solidity", "Markdown", "comment", "blank", "total"
"/Users/user/init/10k1day/1025/1000/StableSwap.sol", "Solidity", -40, 0, -1, -10, -51
"/Users/user/init/10k1day/1025/1000/swap.sol", "Solidity", -14, 0, -7, -4, -25
"/Users/user/init/10k1day/1025/1100/Chainlink.sol", "Solidity", -43, 0, 0, -11, -54
"/Users/user/init/10k1day/1025/1100/CrowdFound.sol", "Solidity", -92, 0, 0, -23, -115
"/Users/user/init/10k1day/1025/1100/DutchAuction.sol", "Solidity", -46, 0, 0, -9, -55
"/Users/user/init/10k1day/1025/1100/EnglishAuction.sol", "Solidity", -15, 0, 0, -6, -21
"/Users/user/init/10k1day/1025/1100/Proxy.sol", "Solidity", -36, 0, 0, -11, -47
"/Users/user/init/10k1day/1025/1200/Bitwise.sol", "Solidity", -27, 0, 0, -11, -38
"/Users/user/init/10k1day/1025/1200/CSAMM.sol", "Solidity", -68, 0, 0, -10, -78
"/Users/user/init/10k1day/1025/1200/ContractSize.sol", "Solidity", -31, 0, 0, -7, -38
"/Users/user/init/10k1day/1025/1200/ExternalContract.sol", "Solidity", -20, 0, 0, -8, -28
"/Users/user/init/10k1day/1025/1200/HoneyPot.sol", "Solidity", -46, 0, 0, -14, -60
"/Users/user/init/10k1day/1025/1200/Overflow.sol", "Solidity", -30, 0, 0, -10, -40
"/Users/user/init/10k1day/1025/1200/Randomness.sol", "Solidity", -24, 0, 0, -6, -30
"/Users/user/init/10k1day/1025/1300/DataLocations.sol", "Solidity", -31, 0, 0, -6, -37
"/Users/user/init/10k1day/1025/1300/FunctionModifier.sol", "Solidity", -35, 0, 0, -10, -45
"/Users/user/init/10k1day/1025/1300/Library.sol", "Solidity", -36, 0, 0, -14, -50
"/Users/user/init/10k1day/1025/1300/MerkleTree.sol", "Solidity", -47, 0, 0, -9, -56
"/Users/user/init/10k1day/1025/1300/MultiDelegatecall.sol", "Solidity", -64, 0, 0, -17, -81
"/Users/user/init/10k1day/1025/1300/MultiSigWallet.sol", "Solidity", -113, 0, 0, -27, -140
"/Users/user/init/10k1day/1025/1300/Vault.sol", "Solidity", -31, 0, 0, -8, -39
"/Users/user/init/10k1day/1025/1400/Create2.sol", "Solidity", -27, 0, 0, -7, -34
"/Users/user/init/10k1day/1025/1400/SendingEther.sol", "Solidity", -19, 0, 0, -5, -24
"/Users/user/init/10k1day/1025/1400/Super.sol", "Solidity", -34, 0, 0, -11, -45
"/Users/user/init/10k1day/1025/1400/UpgradeableProxy.sol", "Solidity", -141, 0, 0, -44, -185
"/Users/user/init/10k1day/1025/1500/BiDirectionalPayment.sol", "Solidity", -67, 0, 0, -16, -83
"/Users/user/init/10k1day/1025/1500/CallingContract.sol", "Solidity", -28, 0, 0, -9, -37
"/Users/user/init/10k1day/1025/1500/ERC721.sol", "Solidity", -34, 0, 0, -21, -55
"/Users/user/init/10k1day/1025/1500/Inheritance.sol", "Solidity", -36, 0, 0, -11, -47
"/Users/user/init/10k1day/1025/900/erc20.sol", "Solidity", -39, 0, 0, -8, -47
"/Users/user/init/10k1day/1025/900/erc721.sol", "Solidity", -11, 0, 0, -5, -16
"/Users/user/init/10k1day/1025/900/stakingRewards.sol", "Solidity", -94, 0, -1, -29, -124
"/Users/user/init/10k1day/1025/行数.md", "Markdown", 0, -16, 0, -1, -17
"/Users/user/init/10k1day/1027/1000/ICallee.sol", "Solidity", 11, 0, 15, 5, 31
"/Users/user/init/10k1day/1027/1100/DssProxyActionsBase.sol", "Solidity", 168, 0, 28, 38, 234
"/Users/user/init/10k1day/1027/1100/ISynth.sol", "Solidity", 7, 0, 5, 5, 17
"/Users/user/init/10k1day/1027/1100/ISynthetix.sol", "Solidity", 9, 0, 0, 8, 17
"/Users/user/init/10k1day/1027/1200/IDepot.sol", "Solidity", 14, 0, 12, 2, 28
"/Users/user/init/10k1day/1027/1200/ILendingPool.sol", "Solidity", 17, 0, 16, 4, 37
"/Users/user/init/10k1day/1027/1200/ILendingPoolAddressesProvider.sol", "Solidity", 11, 0, 9, 3, 23
"/Users/user/init/10k1day/1027/1200/ISynthetix.sol", "Solidity", 22, 0, 19, 3, 44
"/Users/user/init/10k1day/1027/1200/sol.sol", "Solidity", 0, 0, 0, 1, 1
"/Users/user/init/10k1day/1027/1300/IDss.sol", "Solidity", 48, 0, 23, 8, 79
"/Users/user/init/10k1day/1027/1300/IUniswapExchange.sol", "Solidity", 17, 0, 14, 3, 34
"/Users/user/init/10k1day/1027/1300/IUniswapV2Pair.sol", "Solidity", 29, 0, 19, 4, 52
"/Users/user/init/10k1day/1027/1300/sol.sol", "Solidity", 0, 0, 0, 1, 1
"/Users/user/init/10k1day/1027/1400/ICurveFiCurve.sol", "Solidity", 28, 0, 25, 4, 57
"/Users/user/init/10k1day/1027/1400/ICurveFiZap.sol", "Solidity", 11, 0, 9, 2, 22
"/Users/user/init/10k1day/1027/1400/ISoloMargin.sol", "Solidity", 106, 0, 64, 17, 187
"/Users/user/init/10k1day/1027/1400/IUniswapV2Factory.sol", "Solidity", 10, 0, 7, 4, 21
"/Users/user/init/10k1day/1027/1400/IUniswapV2Router01.sol", "Solidity", 100, 0, 16, 3, 119
"/Users/user/init/10k1day/1027/1400/sol.sol", "Solidity", 0, 0, 0, 1, 1
"/Users/user/init/10k1day/1027/1500/BPool.sol", "Solidity", 46, 0, 46, 2, 94
"/Users/user/init/10k1day/1027/1500/ExchangeProxy.sol", "Solidity", 56, 0, 6, 4, 66
"/Users/user/init/10k1day/1027/1500/ICEther.sol", "Solidity", 14, 0, 12, 3, 29
"/Users/user/init/10k1day/1027/1500/ICToken.sol", "Solidity", 14, 0, 12, 3, 29
"/Users/user/init/10k1day/1027/1500/IComptroller.sol", "Solidity", 22, 0, 20, 13, 55
"/Users/user/init/10k1day/1027/1500/sol.sol", "Solidity", 0, 0, 0, 1, 1
"/Users/user/init/10k1day/1027/1600/Chainlink.sol", "Solidity", 25, 0, 5, 6, 36
"/Users/user/init/10k1day/1027/1600/CrowdFund.sol", "Solidity", 96, 0, 30, 24, 150
"/Users/user/init/10k1day/1027/1600/DutchAuction.sol", "Solidity", 47, 0, 32, 10, 89
"/Users/user/init/10k1day/1027/1600/IDssProxyActions.sol", "Solidity", 144, 0, 64, 13, 221
"/Users/user/init/10k1day/1027/1600/IMedianizer.sol", "Solidity", 19, 0, 16, 2, 37
"/Users/user/init/10k1day/1027/1600/MerkleTree.sol", "Solidity", 19, 0, 14, 3, 36
"/Users/user/init/10k1day/1027/1600/TimeLock.sol", "Solidity", 4, 0, 0, 1, 5
"/Users/user/init/10k1day/1027/1600/sol.sol", "Solidity", 0, 0, 0, 1, 1
"/Users/user/init/10k1day/1027/1700/AbiDecode.sol", "Solidity", 15, 0, 10, 4, 29
"/Users/user/init/10k1day/1027/1700/EnglishAuction.sol", "Solidity", 63, 0, 6, 16, 85
"/Users/user/init/10k1day/1027/1700/Signareture.sol", "Solidity", 0, 0, 0, 1, 1
"/Users/user/init/10k1day/1027/1700/StakingRewards.sol", "Solidity", 105, 0, 37, 7, 149
"/Users/user/init/10k1day/1027/1700/UniDirectionalPaymentChannel.sol", "Solidity", 44, 0, 10, 14, 68
"/Users/user/init/10k1day/1027/1700/UpgradeableProxy.sol", "Solidity", 16, 0, 2, 6, 24
"/Users/user/init/10k1day/1027/1700/sol.sol", "Solidity", 0, 0, 0, 1, 1
"/Users/user/init/10k1day/1027/1800/sol.sol", "Solidity", 0, 0, 0, 1, 1
"/Users/user/init/10k1day/1027/1900/sol.sol", "Solidity", 0, 0, 0, 1, 1
"/Users/user/init/10k1day/1027/2000/sol.sol", "Solidity", 0, 0, 0, 1, 1
"/Users/user/init/10k1day/1027/2100/sol.sol", "Solidity", 0, 0, 0, 1, 1
"/Users/user/init/10k1day/1027/2200/sol.sol", "Solidity", 0, 0, 0, 1, 1
"/Users/user/init/10k1day/1027/2300/sol.sol", "Solidity", 0, 0, 0, 1, 1
"/Users/user/init/10k1day/1027/900/IUniswapExchange.sol", "Solidity", 37, 0, 10, 2, 49
"/Users/user/init/10k1day/1027/行数.md", "Markdown", 0, 16, 0, 1, 17
"Total", "-", -25, 0, 604, -138, 441