"filename", "language", "JavaScript", "Markdown", "Solidity", "comment", "blank", "total"
"/Users/user/init/myApp/1day10k/1130/TimeLock.sol", "Solidity", 0, 0, 25, 0, 6, 31
"/Users/user/init/myApp/1day10k/1130/auction/Auction.sol", "Solidity", 0, 0, 64, 52, 23, 139
"/Users/user/init/myApp/1day10k/1130/auction/auction.js", "JavaScript", 45, 0, 0, 0, 12, 57
"/Users/user/init/myApp/1day10k/1130/auction/auction.test.js", "JavaScript", 20, 0, 0, 1, 5, 26
"/Users/user/init/myApp/1day10k/1130/count/count.js", "JavaScript", 24, 0, 0, 0, 5, 29
"/Users/user/init/myApp/1day10k/1130/count/count.sol", "Solidity", 0, 0, 34, 0, 13, 47
"/Users/user/init/myApp/1day10k/1130/count/count.test.js", "JavaScript", 5, 0, 0, 0, 2, 7
"/Users/user/init/myApp/1day10k/1130/count/countSol.js", "JavaScript", 22, 0, 0, 0, 6, 28
"/Users/user/init/myApp/1day10k/1130/deploy.js", "JavaScript", 0, 0, 0, 0, 1, 1
"/Users/user/init/myApp/1day10k/1130/erc20/ERC20.sol", "Solidity", 0, 0, 44, 0, 15, 59
"/Users/user/init/myApp/1day10k/1130/erc20/erc20.js", "JavaScript", 16, 0, 0, 0, 5, 21
"/Users/user/init/myApp/1day10k/1130/erc20/erc20.test.js", "JavaScript", 0, 0, 0, 0, 1, 1
"/Users/user/init/myApp/1day10k/1130/erc721/ERC721.sol", "Solidity", 0, 0, 37, 0, 9, 46
"/Users/user/init/myApp/1day10k/1130/erc721/erc721.test.js", "JavaScript", 0, 0, 0, 0, 1, 1
"/Users/user/init/myApp/1day10k/1130/line.md", "Markdown", 0, 16, 0, 0, 0, 16
"/Users/user/init/myApp/1day10k/1130/other/10000/10000.sol", "Solidity", 0, 0, 50, 3, 22, 75
"/Users/user/init/myApp/1day10k/1130/other/1130/1000/test.md", "Markdown", 0, 0, 0, 0, 1, 1
"/Users/user/init/myApp/1day10k/1130/other/1130/1100/NewContract.sol", "Solidity", 0, 0, 19, 0, 3, 22
"/Users/user/init/myApp/1day10k/1130/other/1130/1100/Vault.sol", "Solidity", 0, 0, 43, 0, 19, 62
"/Users/user/init/myApp/1day10k/1130/other/1130/1100/test.md", "Markdown", 0, 0, 0, 0, 1, 1
"/Users/user/init/myApp/1day10k/1130/other/1130/1200/UniDirectionalPayment.sol", "Solidity", 0, 0, 19, 0, 7, 26
"/Users/user/init/myApp/1day10k/1130/other/1130/1200/test.md", "Markdown", 0, 0, 0, 0, 1, 1
"/Users/user/init/myApp/1day10k/1130/other/1130/1200/test.sol", "Solidity", 0, 0, 15, 1, 9, 25
"/Users/user/init/myApp/1day10k/1130/other/1130/1300/test.md", "Markdown", 0, 0, 0, 0, 1, 1
"/Users/user/init/myApp/1day10k/1130/other/1130/1400/test.md", "Markdown", 0, 0, 0, 0, 1, 1
"/Users/user/init/myApp/1day10k/1130/other/1130/1500/test.md", "Markdown", 0, 0, 0, 0, 1, 1
"/Users/user/init/myApp/1day10k/1130/other/1130/1600/test.md", "Markdown", 0, 0, 0, 0, 1, 1
"/Users/user/init/myApp/1day10k/1130/other/1130/1700/test.md", "Markdown", 0, 0, 0, 0, 1, 1
"/Users/user/init/myApp/1day10k/1130/other/1130/1800/test.md", "Markdown", 0, 0, 0, 0, 1, 1
"/Users/user/init/myApp/1day10k/1130/other/1130/1900/test.md", "Markdown", 0, 0, 0, 0, 1, 1
"/Users/user/init/myApp/1day10k/1130/other/1130/2000/test.md", "Markdown", 0, 0, 0, 0, 1, 1
"/Users/user/init/myApp/1day10k/1130/other/1130/2100/test.md", "Markdown", 0, 0, 0, 0, 1, 1
"/Users/user/init/myApp/1day10k/1130/other/1130/2200/test.md", "Markdown", 0, 0, 0, 0, 1, 1
"/Users/user/init/myApp/1day10k/1130/other/1130/2300/test.md", "Markdown", 0, 0, 0, 0, 1, 1
"/Users/user/init/myApp/1day10k/1130/other/1130/800/test.md", "Markdown", 0, 0, 0, 0, 1, 1
"/Users/user/init/myApp/1day10k/1130/other/1130/900/test.md", "Markdown", 0, 0, 0, 0, 1, 1
"/Users/user/init/myApp/1day10k/1130/other/1130/行数.md", "Markdown", 0, 16, 0, 0, 0, 16
"/Users/user/init/myApp/1day10k/1130/other/board/board.js", "JavaScript", 4, 0, 0, 0, 3, 7
"/Users/user/init/myApp/1day10k/1130/other/board/board.sol", "Solidity", 0, 0, 3, 0, 2, 5
"/Users/user/init/myApp/1day10k/1130/other/farm.sol", "Solidity", 0, 0, 18, 0, 5, 23
"/Users/user/init/myApp/1day10k/1130/other/payment.sol", "Solidity", 0, 0, 20, 0, 8, 28
"/Users/user/init/myApp/1day10k/1130/stake/staking.sol", "Solidity", 0, 0, 40, 9, 16, 65
"/Users/user/init/myApp/1day10k/1130/todo/todo.js", "JavaScript", 43, 0, 0, 0, 8, 51
"/Users/user/init/myApp/1day10k/1130/todo/todo.sol", "Solidity", 0, 0, 49, 0, 14, 63
"/Users/user/init/myApp/1day10k/1130/todo/todoSol.js", "JavaScript", 27, 0, 0, 0, 7, 34
"Total", "-", 206, 32, 480, 66, 243, 1027